

##########
         #
         #
         #
         #################################
#                   #                    #
#                                        #
#                   #                    #
#                   ####### ### ### ### ##
#                   #    #   #   #   #   #
#                        #   #   #   #   #
#                   ######################
#####################
                    #
#                   #
#                   #
#####################