#####################
#                   #
#                   #
#######     #########
#                   #
#                   ##########
#                   #        #
#                   #        #############
#                                        #
#                   ##########           #
#                   #                    #
#                   #                    #
##########################           #####